0100110001101100
0100111001101100
0100111001101100
0001111111111111
0111111111111111
